R  1000 500

NO ./textures/wall2.xpm

SO ./textures/wall7.xpm

WE ./textures/wall3.xpm

EA ./textures/wall8.xpm

S ./textures/vdv.xpm

F 10, 100, 10

C 0, 10, 150


        1111111111111111111111111
        1000020000110000000000001
        1011000001110000002000001
        1001000000000000000000001
111111111011000001110000000000001
100000000011000001110111111111111
11110111111111211100000010001
11112111111111011101010010001
11000000120101011102000010001
100000200W0000001100000010001
12000000000000000001010010001
1100000111010101111101111000111
11110111 1110101 101111010001
11111111 1111111 111111111111
