R 2000 100


NO ./textures/wall1.xpm
SO ./textures/wall5.xpm
WE ./textures/wall6.xpm
EA ./textures/wall7.xpm
S ./textures/ss.xpm
C 100, 150, 255
F 0, 0, 0

1111111
1200001
1002W01
1200001
1111111